R 700 700
NO petya.xpm
SO taras.xpm
WE stas.xpm
EA kakos.xpm
S kazoo.xpm
C 255,242,201
F 157,190,245

        1111111111111111111111111
        1000000000110000000000001
        1011000001110000000000001
        1001000000000000000000001
111111111011000001110000000000001
100000000011000001110000000011111
11110111111111011100000010001
11110111111111011101010010001
11000000110101011100000000001
10000000000000001100000000001
10000000000000001101010000001
11000001110101011111011000N0111
11110111 1110101 101111010001
11111111 1111111 111111111111
