R 500 500
NO petya.xpm
SO taras.xpm
WE stas.xpm
EA kakos.xpm
S kazoo.xpm
C 255,242,201
F 157,190,245

11111111
10000001
1000S001
10000001
10000001
11111111